%%%%%%%
%    G%
% %%% %
%  %  %
%%   %%
%S %%%%
%%%%%%%